_________WW__WW_________
_WWWWW____________WWWWW_
_W___W____________W___W_
_W____________________W_
_W___W____________W___W_
_WW_WW___WW__WW___WW_WW_
_________W____W_________
________________________
_________W____W_________
_________WW__WW_________
_WW_WW____________WW_WW_
_W___W____________W___W_
_W____________________W_
_W___W____________W___W_
_WWWWW____________WWWWW_
_________WW__WW_________
