________________________
_W______________________
_W______________________
_W___W__WWWWWWWWWWW_____
_W___W__W_________W_____
_W___W__W_WWWWWW__W_____
_W___W__W_W____W__W_____
_W___W__W_W__W_W__W_____
_W___W__W____W_W__W_____
_W___W__WWWWWW_W__W_____
_W___W_________W__W_____
_W___WWWWWWWWWWW__W_____
________________________
_W______________________
_WW_WWWWWWWWWWWWWWWWWW__
________________________
