______W__________W______
______W__________W______
______W__________W______
______W__________W______
WWWWWWW__________WWWWWWW
________________________
_________WW__WW_________
________________________
________________________
_________WW__WW_________
________________________
WWWWWWW__________WW___WW
______W__________W______
______W_________________
______W_________________
______W__________W______
