____W_____W___W____W____
____W_____W___W____W____
____W_____W___W____W____
____W_____W___W_________
WWW_W_____W___W____WWWWW
__________W___W_________
WWWWWW____W___W___WWWWWW
_____W____________W_____
__________WWWWW_________
_____W____________W_____
WWWWWW____W___W___WWWWWW
__________W___W_________
WWWWW_____W___W____W_WWW
__________W___W____W____
____W_____W___W____W____
____W_____W___W____W____
